0 0 0 0 0 0 0 0 1 0 1 1 1 2 2 0 1 2 1 1 2 0 1 1 1 2 1 0 1 1 1 2 1 0 1 0 1 1 1 2 2 2 2 1 1 1 1 0 2 0 1 1 1 0 2 0 1 1 1 2 1 1 1 0 1 2 1 1 1 1 2 1 1 1 1 2 1 1 2 2 1 2 1 1 1 0 2 1 1 2 1 1 1 2 1 1 1 2 1 0 1 2 2 0 1 2 1 1 1 1 1 1 1 1 1 2 1 1 1 1 1 2 1 0 1 2 1 2 1 1 2 1 1 2 1 2 1 1 1 1 1 2 1 2 1 2 1 0 1 2 2 0 1 2 1 2 1 1 1 1 1 0 1 2 2 2 1 1 1 0 1 1 2 0 1 1 1 2 1 0 1 0 1 1 1 1 2 0 1 1 1 0 1 2 1 1 1 1 1 2 1 1 1 0 1 1 1 1 1 1 1 1 1 1 1 0 1 2 1 2 1 2 1 1 1 1 1 2 1 2 1 2 1 0 1 0 1 0 1 2 2 1 1 0 1 1 2 2 1 2 1 0 2 1 1 2 1 1 1 1 2 2 1 0 2 2 1 1 1 0 1 1 1 1 2 0 1 2 1 0 1 1 1 2 1 0 1 0 1 2 1 2 1 1 1 1 1 0 1 1 2 0 1 2 1 2 1 1 2 1 1 2 2 1 1 1 1 0 1 1 1 1 1 2 1 1 2 1 1 1 1 1 1 1 1 2 1 0 1 0 1 1 1 2 1 1 1 2 1 2 1 1 1 2 1 1 1 2 2 1 
0 0 0 0 0 0 0 0 1 0 2 2 2 0 0 0 1 0 2 1 0 0 2 2 2 0 1 0 1 2 1 0 1 0 2 0 1 2 1 0 0 0 0 2 1 2 1 0 0 0 1 2 2 0 0 0 2 1 1 0 2 1 1 0 2 0 1 2 2 2 0 2 1 2 1 0 2 2 0 0 1 0 1 2 1 0 0 2 1 0 2 2 1 0 1 2 1 0 2 6 1 0 0 0 2 0 1 1 2 2 2 2 1 2 1 0 1 2 2 1 1 0 1 0 1 0 2 0 2 2 0 2 1 0 1 0 2 2 1 1 1 0 1 0 1 0 1 0 1 0 0 0 1 0 1 6 1 2 2 1 1 0 2 0 0 0 2 2 2 0 2 2 0 0 1 1 1 0 2 0 1 0 1 2 1 2 0 0 1 1 1 0 2 0 2 2 2 2 1 0 1 2 2 0 1 2 2 1 2 2 1 1 1 2 1 0 1 0 1 0 2 0 1 2 2 2 1 0 1 0 1 0 1 0 2 0 1 0 1 0 0 2 1 0 1 2 0 0 1 6 2 0 0 2 1 0 1 2 1 2 0 0 1 0 0 0 1 2 1 0 2 2 1 2 0 0 1 0 2 0 1 2 2 0 1 0 1 0 1 0 2 0 2 2 2 2 2 0 1 2 0 0 2 0 1 6 1 2 0 1 2 0 0 1 2 1 1 0 1 1 2 2 1 0 1 2 0 1 1 2 1 2 2 2 2 0 1 0 1 0 2 2 2 0 2 2 1 0 1 0 1 2 1 0 1 2 1 0 0 2 
0 0 0 0 0 0 0 0 1 0 0 0 0 0 0 0 2 0 0 2 0 0 0 0 0 0 2 0 2 0 1 0 1 0 0 0 2 0 2 0 0 0 0 0 2 0 2 0 0 0 2 0 0 0 0 0 0 2 1 0 0 2 1 0 0 0 1 0 0 0 0 0 1 0 2 0 0 0 0 0 2 0 2 0 2 0 0 0 1 0 0 0 2 0 1 0 1 0 0 0 2 0 0 0 0 0 2 2 0 0 0 0 2 0 2 0 1 0 0 2 2 0 2 0 2 0 0 0 6 0 0 0 1 0 2 0 0 0 1 2 2 0 2 0 1 0 2 0 1 0 0 0 2 0 1 0 1 0 0 2 1 0 0 0 0 0 0 0 0 0 0 0 0 0 2 2 2 0 0 0 2 0 2 0 2 0 0 0 1 2 1 0 0 0 0 0 0 0 2 0 1 0 0 0 1 0 0 2 0 0 2 2 2 0 2 0 1 0 2 0 0 0 2 0 0 0 1 0 2 0 2 0 2 0 0 0 2 0 2 0 6 0 2 0 2 0 0 0 2 0 0 0 0 0 2 0 2 0 2 0 0 0 1 0 0 0 2 0 2 0 0 0 2 0 0 0 2 0 0 0 2 0 0 0 1 6 1 0 1 0 0 0 6 0 0 0 0 0 2 0 0 0 0 6 1 0 2 0 0 2 0 0 0 2 0 2 1 0 2 2 0 0 2 0 2 0 0 2 2 0 2 0 0 0 0 0 1 0 2 0 0 0 6 0 0 0 2 0 1 0 2 0 2 0 1 0 1 0 0 0 
0 0 0 0 0 0 0 0 2 0 0 0 0 0 0 0 0 0 0 0 0 0 0 0 0 0 0 0 0 0 2 0 2 0 0 0 0 0 6 0 0 0 0 0 0 0 0 0 0 0 0 0 0 0 0 6 0 0 2 0 0 0 2 0 0 0 2 0 0 0 0 0 2 0 0 0 0 0 0 0 0 0 0 0 0 0 0 0 2 0 0 0 0 0 2 0 2 0 0 0 0 0 0 0 0 0 0 0 0 0 0 0 0 0 0 0 2 0 0 0 0 0 0 0 0 0 0 0 0 0 0 0 2 0 0 0 0 0 2 0 0 0 0 0 2 0 0 0 2 0 6 0 0 0 2 0 2 0 0 0 2 0 0 0 0 0 0 0 0 0 0 0 0 0 0 0 0 0 0 0 0 0 0 0 0 0 0 0 2 0 2 0 0 0 0 0 0 0 0 0 2 0 0 0 2 0 0 0 0 0 0 0 0 0 0 0 2 0 6 0 0 0 0 0 0 0 2 0 0 0 0 0 0 0 0 0 0 0 0 0 0 0 0 0 0 0 0 0 0 0 0 0 0 0 0 0 0 0 0 0 0 0 2 0 0 0 0 0 0 0 0 0 0 0 0 0 0 0 0 0 0 0 0 0 2 0 2 0 2 0 0 0 0 0 0 6 0 0 0 0 0 0 0 0 2 0 0 0 0 0 0 0 0 0 0 0 2 0 0 0 0 0 0 0 0 0 0 0 0 0 0 0 0 0 0 0 2 0 0 0 0 0 0 0 0 0 0 0 2 0 0 0 0 0 2 0 2 0 0 0 
0 0 0 0 0 0 0 0 0 0 0 0 0 0 0 0 0 0 0 0 0 6 0 0 0 0 0 0 6 0 0 0 0 0 0 0 0 0 0 0 0 0 0 0 0 0 0 0 0 0 0 0 0 0 0 0 0 0 0 0 0 0 0 0 0 0 0 0 0 0 0 0 0 0 0 0 0 0 0 0 0 0 0 0 0 0 0 0 0 0 0 0 0 0 0 0 0 0 0 0 0 0 0 0 0 0 0 0 0 6 0 0 0 0 0 0 0 0 0 0 0 0 0 6 0 0 0 0 0 0 0 0 0 0 0 0 0 0 0 0 0 0 0 0 0 0 0 0 0 0 0 0 0 0 0 0 0 0 0 0 0 0 0 0 0 6 0 0 0 0 0 0 0 0 0 0 0 0 6 0 0 0 0 0 0 0 0 0 0 0 0 0 0 6 0 0 0 0 0 0 0 0 0 0 0 0 0 0 0 0 0 0 0 0 0 0 0 0 0 0 0 0 0 0 0 0 0 0 0 0 0 0 0 0 0 0 0 0 0 0 0 0 0 0 0 0 0 0 0 0 0 0 0 0 6 0 0 0 0 0 0 0 0 0 0 0 0 0 0 0 0 0 0 0 0 0 0 0 6 0 0 0 0 0 6 0 0 0 0 0 0 0 0 6 0 0 0 0 0 0 0 0 0 0 0 0 0 0 0 0 0 0 0 0 0 6 0 0 0 0 0 0 0 0 0 0 0 0 0 0 0 0 0 0 0 0 0 0 0 0 0 0 0 0 0 0 0 0 0 0 0 0 0 0 0 0 0 0 0 0 
0 0 0 0 0 0 0 0 0 0 0 0 0 0 0 0 0 0 0 0 0 0 0 0 0 0 0 0 0 0 0 0 0 0 0 0 0 0 0 0 6 0 0 0 0 0 0 0 0 0 0 0 0 0 0 0 0 0 0 0 0 0 0 0 0 6 0 0 0 0 0 0 0 0 0 0 0 0 0 0 0 0 0 0 0 0 0 0 0 0 0 0 0 0 0 0 0 0 0 0 0 0 0 0 0 0 0 0 0 0 0 0 0 0 0 0 0 0 0 0 0 0 0 0 0 0 0 0 0 0 6 0 0 0 0 0 0 0 0 0 0 0 0 0 0 0 0 0 0 0 0 0 0 0 0 0 0 0 0 0 0 0 0 0 0 0 0 0 0 0 6 0 0 0 0 0 0 0 0 0 0 0 0 0 0 6 0 0 0 0 0 0 0 0 0 0 0 0 0 0 0 0 0 0 0 0 0 0 0 0 0 0 0 0 0 0 0 6 0 0 0 0 0 0 0 0 0 0 0 0 0 0 0 0 0 0 0 0 0 0 0 0 0 0 0 0 0 0 0 0 0 0 0 0 0 0 0 0 0 0 0 6 0 0 0 0 0 0 0 0 0 0 0 0 0 0 0 0 0 0 0 0 0 0 0 0 0 0 0 0 0 0 0 0 0 0 0 0 0 0 0 0 0 0 0 0 0 0 0 0 0 0 0 0 0 0 0 0 0 6 0 0 0 0 0 0 0 6 0 0 0 0 0 0 0 0 0 0 0 0 0 0 0 0 0 0 0 0 0 0 0 0 0 0 0 0 0 0 0 0 
0 0 0 0 0 0 0 0 0 0 0 0 0 0 4 0 0 0 0 0 4 0 0 0 0 0 0 0 4 0 0 0 0 0 0 0 0 0 0 0 0 0 4 0 0 0 0 6 0 0 4 0 0 0 0 0 4 0 0 0 4 0 0 0 0 0 0 0 0 0 4 0 0 0 0 0 0 0 4 0 4 0 4 0 4 0 0 6 0 0 4 0 0 0 0 0 0 0 4 0 0 0 0 0 0 0 0 0 0 0 0 0 0 0 0 0 0 0 0 0 0 0 0 0 4 0 0 0 4 0 0 0 0 0 4 0 0 0 0 0 0 0 0 0 0 0 0 0 0 0 4 0 4 0 0 0 0 0 0 0 0 0 0 0 4 0 4 0 0 0 4 0 6 0 0 0 0 0 4 0 0 0 4 0 0 6 4 0 0 0 0 0 0 0 4 0 0 0 0 0 0 0 4 0 0 0 0 0 0 0 0 0 0 0 0 0 0 0 0 0 0 0 4 0 0 0 6 0 0 0 0 0 0 0 0 0 0 0 0 0 0 0 4 0 0 0 4 0 0 0 4 0 0 0 4 0 0 0 0 6 0 0 0 0 4 0 4 0 0 0 0 0 0 0 4 0 0 6 0 0 0 0 0 0 0 0 0 0 0 0 0 0 4 0 4 0 0 0 4 0 0 0 4 0 0 0 0 0 0 0 0 0 0 0 0 0 0 0 0 0 4 0 0 0 0 0 4 0 4 0 0 0 0 0 0 0 0 0 0 0 0 0 0 0 0 0 0 0 0 0 4 0 0 0 0 0 0 0 4 0 
0 0 0 0 0 0 0 0 0 0 0 0 0 0 3 0 4 4 0 0 3 0 4 0 0 0 4 0 3 0 0 0 0 0 0 0 4 0 0 0 4 0 3 0 0 0 0 0 4 0 3 0 0 0 4 0 3 0 0 4 3 0 4 0 0 0 0 0 4 0 3 0 0 0 0 0 4 0 3 0 3 6 3 0 3 0 4 0 4 0 3 0 4 0 0 0 0 0 3 0 0 4 6 0 0 4 4 0 4 0 4 0 0 0 0 0 0 0 4 0 4 0 4 0 3 0 4 0 3 0 0 0 0 4 3 4 0 0 0 0 4 0 4 0 4 4 4 0 0 4 3 6 3 0 0 0 0 0 0 0 4 0 0 4 3 0 3 0 4 0 3 0 0 0 0 0 0 0 3 0 4 0 3 0 0 0 3 0 0 0 0 0 0 0 3 0 0 0 0 6 4 0 3 0 4 0 4 0 4 0 4 0 4 0 4 0 0 0 0 0 0 0 3 0 0 0 0 0 0 4 0 0 0 0 0 0 0 0 0 0 4 0 3 0 4 0 3 4 4 0 3 0 4 0 3 0 4 0 0 0 4 0 4 0 3 0 3 0 4 0 0 0 4 0 3 0 0 0 0 0 4 0 4 0 0 0 0 0 4 0 0 4 3 0 3 0 0 0 3 0 0 0 3 0 0 0 0 0 4 0 0 0 0 0 0 0 4 0 4 0 3 0 4 0 0 0 3 0 3 0 4 0 4 0 0 4 0 0 0 0 6 0 4 0 4 0 0 4 4 0 3 0 4 4 4 0 0 0 3 0 
0 0 0 0 0 0 0 0 0 0 4 0 4 4 3 0 3 3 4 0 3 0 3 4 4 0 3 0 3 0 4 0 0 0 0 0 3 0 0 0 3 0 3 4 4 0 4 0 3 0 3 0 0 0 3 0 3 0 0 3 3 0 3 0 4 0 4 4 3 4 3 4 0 4 4 0 3 4 3 0 3 0 3 4 3 0 3 0 3 4 3 0 3 0 4 4 0 4 3 0 0 3 4 6 4 3 3 0 3 4 3 0 4 4 0 0 0 4 3 0 3 4 3 0 3 0 3 4 3 4 4 4 0 3 3 3 4 4 0 0 3 0 3 4 3 3 3 0 4 3 3 0 3 0 6 0 4 0 4 0 3 0 4 3 3 0 3 0 3 0 3 4 4 0 4 0 0 0 3 0 3 0 3 4 0 4 3 0 4 0 0 0 4 4 3 4 4 4 0 0 3 4 3 0 3 4 3 0 3 4 3 0 3 0 3 0 0 4 0 0 4 4 3 4 4 4 0 4 4 3 0 4 0 0 4 0 4 0 0 0 3 4 3 0 3 4 3 3 3 4 3 0 3 4 3 0 3 4 0 4 3 0 3 0 3 4 3 0 3 0 4 0 3 0 3 0 0 4 4 0 3 4 3 4 0 0 0 0 3 0 4 3 3 4 3 4 0 0 3 4 4 0 3 4 0 4 4 4 3 0 0 0 4 0 0 0 3 0 3 0 3 4 3 0 0 4 3 0 3 0 3 4 3 4 4 3 0 0 0 0 4 4 3 4 3 0 0 3 3 4 3 0 3 3 3 0 0 4 3 4 
0 0 0 0 0 0 0 0 4 0 3 4 3 3 3 0 3 3 3 4 3 4 3 3 3 0 3 4 3 4 3 0 4 0 4 0 3 4 4 0 3 0 3 3 3 4 3 4 3 4 3 4 4 4 3 4 3 4 4 3 3 4 3 0 3 0 3 3 3 3 3 3 4 3 3 0 3 3 3 0 3 0 3 3 3 4 3 4 3 3 3 4 3 0 3 3 4 3 3 4 4 3 3 4 3 3 3 4 3 3 3 4 3 3 4 0 4 3 3 4 3 3 3 0 3 0 3 3 3 3 3 3 4 3 3 3 3 3 4 4 3 0 3 3 3 3 3 4 3 3 3 0 3 0 4 0 3 4 3 4 3 4 3 3 3 0 3 4 3 0 3 3 3 4 3 4 4 0 3 4 3 4 3 3 4 3 3 4 3 4 4 0 3 3 3 3 3 3 4 0 3 3 3 4 3 3 3 4 3 3 3 4 3 4 3 4 4 3 4 0 3 3 3 3 3 3 4 3 3 3 4 3 4 4 3 0 3 4 4 0 3 3 3 0 3 3 3 3 3 3 3 0 3 3 3 0 3 3 4 3 3 0 3 0 3 3 3 4 3 4 3 4 3 4 3 4 4 3 3 0 3 3 3 3 4 4 4 4 3 0 3 3 3 3 3 3 4 0 3 3 3 0 3 3 4 3 3 3 3 4 4 0 3 4 4 4 3 4 3 4 3 3 3 0 4 3 3 4 3 4 3 3 3 3 3 3 4 4 4 4 3 3 3 3 3 4 4 3 3 3 3 4 3 3 3 4 4 3 3 3 
